A	AH
A(2)	EY
B	B IY
C	S IY
D	D IY
E	IY
F	EH F
G	JH IY
H	EY CH
HANGMAN	HH AE NG M AH N
I	AY
J	JH EY
K	K EY
L	EH L
M	EH M
N	EH N
O	OW
P	P IY
Q	K Y UW
QUIT	K W IH T
R	AA R
S	EH S
SPEAK	S P IY K
START	S T AA R T
STOP	S T AA P
T	T IY
U	Y UW
V	V IY
W	D AH B AH L Y UW
X	EH K S
Y	W AY
Z	Z IY
